R 1000 1000
NO ./textures/no.xpm
SO ./textures/so.xpm
WE ./textures/we.xpm
EA ./textures/ea.xpm
S ./textures/cat.xpm
C 225,30,0
F 220,100,0


        1111111111111111111111111
        1000000000110000000000001
        1011000001110000000000001
        1011000001110000000000001
        1011000001110000002000001
        1001000000000000000000001
111111111011000001110000000000001
100000000011000001110111110111111
11110111111111011100000010001
11110111111111011101010000001
11000000110101011100000010001
10002000000000001100000010001
10000000000000001101010010001
1100000111010101111101101000111
11110111 1110101 101111000N01
11111111 1111111 111111111111
